NO textures/test/north.png
SO textures/test/south.png
WE textures/test/west.png
EA textures/test/east.png

F 20,20,20
C 200,200,200

11111
100001
10S001
100001
100001
100011
1101
100011
1000011
1000011
1000011
1010101 1
11  1 11
11 11 1
11 11 1
      1